11111111111
10000000C01
10E00000001
10000P00001
11111111111